........#.....................#.........#.#.....#.
..##.......#...................................#..
......#.......#.....#........#....##...#..........
..........................#.......................
.#............................................#...
...#..........#.#..#.......#..#...............#...
..................................................
.............................#.#........#.........
#.#.........#................##...................
#...#.......###.....#......#.........#..#......#..
........#...................#.#.#....#............
.....#.#...........#.......#..#....#..............
.#.........##............#....###...#..#..........
............................#....#......#..##.....
..............#........#.#..............#.........
..................#........##.................#..#
....##.........................#..................
..#...#........................................#..
......................#..#......#....#..#......#..
##...#....................#..............#....#...
#.....................#.......#..#...............#
.....#......#............#........#........#....#.
.......#.............#....#.....................#.
##..#...............................#....##....#..
..........#.....#........#.........#.......##.#...
........#...#.........#....................#......
................#..#...#......#........#.#...#....
.............#....#.........#....#.....#..#.......
.......#.....#...#...#....#.......................
...#....#.#.....................#.##.#......#....#
.......#.....#....................................
.....#.........#..#..#.............#.............#
...#.....#...............#..#.................#...
.............##....................#....#.........
.......#.......#..#.........#..##........#........
.......................#..#........#..............
........#........#..........#.......#..#.........#
...................#.#...#.#.......#..........#...
.....##..........#.................##....#........
............................#...#................#
.....................#......#.#....#...##.........
.....##.................#.#.....#.................
...............#......#.##...#....................
...#......#..#.....#..............#......#........
........#.#.......#..........................#....
...#........#.##...........#..................#..#
..................#.....#.......#..........#..#...
...#.#..#...........##..#.........................
..............#.......#....#.............#..#.#...
..........#....#.#.#...#...#......................

.............#..............#.....#.........#.....
.........#..............#............##.....#.....
#..#........#.......#...............#.#...........
..#............#.......#.....#..........#..#...#..
........#.........#....#..............#..#....#...
.......#....#...#.............#........#..........
.#.#.......................................###...#
....#.........#..#.......#..........#......#......
...#.#..#...#............#............#.........#.
....................#..#........#...........#....#
...#.................###...#....#..#..............
#.#.................................#...#.........
..#.......#.................#......#..............
#........................##...#.......#.#..#....#.
.#.............#...............#....#.......#.....
...#...................#...#.....#................
#........................................#........
.............................#..............#.....
...........##............#.....#...........#......
........#.........#.....##........#...............
#....#....###................#.#..#....##.........
...#....#...#..........#.......#...#...#...#......
......#....#..#...#.............#..............#..
..##.....#....#.......#..#..#.....................
.....................#..............#..#....#...#.
....#...............#..#.....................#....
................#.##....#...#...#..#.#...#..#.....
.##.....#.......#............................#....
....#.......#..........#........#.......#.........
............................#.....................
..............#........#.......................#.#
.......#.......#.......................#.#........
.......#.#............#...#..#........#......#....
#.....#....#..........#........#...#..............
....#...#.......#.......##.......#............#...
#..#..........................#...................
.#..#...................##......#...#.....#..#....
...#........#........#............................
.........#..#..........#........#.......#.##......
.#.................#..#...............#.......#...
##.................###............................
......#....#......................................
.#.#..................#............##...#.........
#..............#.......#.....#.#..................
.......#.......#....#.....#........##.#.......#...
.....................#...............#........#..#
...........#.....#...#...#........................
................#.#.......#.#...................#.
.....#......................#.....#.......#..#....
...#.....#..................................#....#

....#.......#...................#.................
#.........##..##........#.......#.................
...##.....#..............#.#....#...#....#...#....
..#..................................#.........#..
....#.#..........................................#
......................#..............#..#.....#...
......#................#..........................
..............................#......##.#......#..
......#.....##..#.#..#............#.....#..#......
..........................#..................#....
.............................##...........#.......
............#...##.....#.....#................#...
....#.........#.#.....#..#..............#.#.......
.....#....#....................##.................
....#.....................#....#...#...##.........
...#................#..#....##..#................#
.............#...#............#........#......#...
.....................###..#......#....##.....#....
...#...#....###.......##...#..#......#............
.................................................#
...........................................#......
#...............................................#.
............#.#.....##...#.#....................#.
.##......................#...#.........##.........
...#.......#..............###.....................
.#...#.......................................#....
........................#...............#.........
......................#.#.............##.#........
#..................#........#..................#..
............#.................#...................
#.........................#...###.................
...........#................#.#.#..#.#.......#....
.........................##....#.....#............
...#.......#.......#............#...#.........#...
.......#...................#.#.........#..##......
....................................#.#...........
..............#........................#..........
......#.#................#...............#..#.....
...#.............#................................
.#....#................................#..........
....##.......#........#...#..#....................
..................#.##....................##....#.
....#.#.....#..............#..........#..#.#..#...
...............#........#..#...............#.#.#..
....#....#.............#........................#.
....#.....................##....#..#..............
.............................................#....
..#.................#.......#................#....
...#..............#..............#.#..............
................#.#........................##.....

....................#................#........#...
.#......#..#.#............#........#..............
.............#...............#....#.............#.
.............#...............#..........#..#...#..
.............................#....................
..###.............#...................##..........
...................#...............#..........#..#
....#.....#.#..........#..........#.....#.........
#.......................#........#................
#........#.....#.....................#..#......#..
.......................#.............#......#.....
..#......#.#.................#..............##....
#.....................#..#...............#......#.
..........#.........#.........#...........#.......
.............#...#..#.......................#..#..
....#......#.#..##................................
.............#...........#.............#....#.....
.............#....................#..#..........#.
.........#..#.............#....#...........#......
..............#...#.##..##..........#..#..........
....................#......##.....................
..#..#....#.#..........#...............#..........
............#....#.#............#......#..........
..........#..............#.....................#..
..#.........................#................#....
#.......#.....#...................................
....#..#..........................#...............
.#..............#..............................#.#
..............#.#........#...................#..#.
......#..........#........................#.......
.#.#..#..#...........##..............#.#.....#....
.....#....#............#.................#.......#
..........#......................#................
...##..................................##......##.
.......................#.................#......#.
#..#.................#......#............#........
...#.....##.#...#........#......#.#...............
..................#..#..##.......#................
......#.#...............................##........
...#..............................................
#.......#............#...............#....#.......
...........#......#............#..................
..#.........#.............##..............#.......
#..............#...........................#......
#..#.##.....##.#.....#.............#...#..........
..................................................
#.......#......................#.........#.#.#....
...#.........................##...................
..#..##.......#....................#...#......#..#
#.....#...............#.#.........#..#.##.........

......#......#..#.....................#..#......#.
..#...#.#.........#.......................#.....#.
.........#....#....##........#.#..##..............
................#......#.........#..........#....#
...........................#.......#..............
......#.....................##.##....#............
...................#.......#.....................#
......#...#....................#..................
................#.........#.#..#...........##.....
#..#.........#.............#..#....#..............
.....#...#...#....#...#.....................##....
................#...#.............................
#...#..#..#.#.#....#............#..#...#.....#....
....#..........#........#....#....#............#..
#....#..#...............#.........................
...............##...#....#.................#......
........................#..#............#..#...#..
......................................#.........##
.......................#.............##.......#...
.......#......#.........#..##.................#...
............................................#.....
...........#......................................
.................#..................#....#...##...
#......###............#.......#....#.....#.......#
#......#..............#....................#......
..............#.#..#.........#....................
..........#......#................................
#....#......#..###..#.................#.#...#...#.
.....#..#..........#..........#..#..##............
..#..........#.......................#......#.....
............#.....................................
...##.#.............................#...........#.
...#..#......#.................#.....#.###........
.#..#......................#..........#...........
..............................#...#.......#.......
.....#....#........................#..............
............#...........................#.........
.....#.........................#................#.
...##....#............................#....#....#.
...#..#......#.........#.........#.......#........
.........................##......#....#...........
..#...##......#...........#.#...###.....#.........
#....#.................#....#..............#...##.
.......#..........#.....#..#......#...............
......##.........#..#..................#..........
#....#..................#.........#............#..
.......#....................#..#........###.......
......#....#...#..#................#.#.......#....
..#..............#..#.....#...........#..#........
#....#......#.............#..#........#...........

..........#...#.................#.................
..#...#..#.#.#.......#...#..#.....#.......#......#
....#..#.........#........................#.......
....#.............................................
..............###................#....#...........
.......#...#...#.................#.#..#...........
#.................................#.......#.......
........................#......#....#...#...#....#
....#.....#.......................#.............#.
...#..............#........#..........#...........
...............................#...............#..
.##.........#......#..#.................#....##...
...#...............#.....#.....#...#.........#.#.#
.............#...............#..###...............
..#...#.....#......#..#.......#...................
........#.........#.................#..#..........
..........#...#........#.........#..#.............
...........................#................#.....
........#..#..............##...............#..#...
.....................#.....#.#...#..#........#....
....#.....#.#..............#.#.......#............
...#...#.........#.#........................#.....
.#.......#..............#.........................
.........................#.#.................#....
..............#...............##.........#...#....
................#......#.................#........
.#...........#........#.............#.##...#......
...............#...#..#...........................
........#.....#....#......##.......#.#............
.....#................#......#..#...........#.....
....#...........#....................#...#........
#......###...#....#..#.....#......................
........................#.............#...........
.............##....#...................#.......#..
.........#...........#...........#................
.........................#.....#..................
.......#.....................#.#....#...........#.
#......................#...........#..#...........
...........#......................#......#.....##.
#..............#.....#........#...................
.....#..##.....#.#..............#.......#.........
.........#......#..#..............................
.#.......................#.............#.......#..
....#..#.#..#..#................#........#...#....
#......#..#......#...............##.............#.
....#...................................#.........
.#.............#.........#......................#.
....#..............#..........##..#...............
...............................#...#.#............
..#...........#...................................